Aliyev	Faig	5
Alloula	Achraf	5
Askaraliev	Shohsulton	5
Baiyeva	Gulzira	5
El Alami	Zakaria	5
Fidelis	Emmanuel Ken	5
Gebre	Lydia	5
Ghole	Eshan	5
Gitego Gashaija	Naomi	5
Hakim	Saad	5
Hasanov	Ibrahim	5
Israel Apeh	Divine	5
Jumshudova	Shovkat	5
Kafalinji	Griven	5
Katena	Wesley	5
Khalafov	Jahangir	5
Lumana	Michel	5
Mohammed	Haris	5
Naeem	Mohammad	5
Nagulan	Sherran	5
Nychai	Marian	5
Rwizi	Tafadzwa	5
Santiago	Anosh	5
Seferoghlu	Gevher	5
Shamshiddinov	Sarkorbek	5
Shine	Annmaria	5
Tran	Van	5
Zhalilov	Nurumbet	5
